NO ./asset/set5/north.xpm
SO ./asset/set5/south.xpm
WE ./asset/set5/west.xpm
EA ./asset/set5/east.xpm

F 220,100,0
C 225,30,0

        1111111111111111111111111
        100000N000110000000000001
        101100N001110000000000001
        1001000000000000000000001
111111111011000001110000000000001
100000000011000001110111111111111
11110111111111011100000010001
11110111111111011101010010001
11000000110101011100000010001
10000000000001100000000010001
10000000000000001101010010001
110000011101010111110111100111
11110111 1110101 101111010001
11111111 1111111 111111111111