NO ./asset/set5/north.xpm
SO ./asset/set5/north.xpm
WE ./asset/set5/north.xpm
EA ./asset/set5/north.xpm

F 5,5,5
C 5,5,5

1111111111111111111111111
1000000000010000000000001
10S0010000100010000000001
1000100000000010000000001
1111110000000000000001111
1000000001010000000100001
1000000101010000000000001
1000000101000111110000001
1111000100000000000001111
1000000000000000000000001
1000000000000000000000001
1000000000001111000000001
1100000000000001011110001
1111000000000000000000001
1111111111111111111111111