NO ./asset/set2/north.xpm
SO ./asset/set2/south.xpm
WE ./asset/set2/west.xpm
EA ./asset/set2/east.xpm

F 5,5,5
C 25,25,40

        1111111111111111111111111
        1000000000110000000000001
        1011000001110000000000001
        1001000000000000000000001
111111111011000001110000000000001
100000000011000001110111110111111
11110111111111011100000010001
11110111111111011101010010001
11000000110101011100000010001
10000000000000001100000010001
10000000000000001101010010001
11000001110001011100000110N0111
111101111110110111010100111001
111101111100110111000000100001
11000000110101011101010010111
10000000000000001000000010001
10000000000000000001010000001
11000001110101011111011110001
11111111111111111111111111111